X,X,X,X,X,X,X,X,X,X,X,X,X,X,X,X,X,X,X,X,X,X,X,X,X,X,X,X,X,X,X,X,X,X,X
X,O,O,O,X,O,O,O,O,O,O,O,O,O,O,O,O,O,O,O,O,O,O,O,O,O,O,O,O,O,X,O,O,O,X
X,O,X,O,X,X,X,O,X,O,X,O,X,X,X,X,X,O,X,O,X,O,X,O,X,O,X,O,X,O,X,O,X,O,X
X,O,O,O,X,O,O,O,X,O,O,O,X,O,X,O,X,O,X,O,O,O,O,O,O,O,O,O,O,O,O,O,O,O,X
X,O,X,O,X,X,X,X,X,O,X,X,X,O,X,O,X,X,X,X,X,O,X,O,X,O,X,O,X,O,X,O,X,O,X
X,O,X,O,O,O,O,O,O,O,X,O,X,O,O,O,O,O,O,O,X,O,O,O,O,O,O,O,O,O,X,O,O,O,X
X,O,X,O,X,O,X,X,X,O,X,O,X,O,X,O,X,O,X,O,X,X,X,O,X,O,X,X,X,O,X,O,X,O,X
X,O,X,O,O,O,O,O,O,O,X,O,O,O,O,O,O,O,O,O,O,O,X,O,O,O,O,O,X,O,O,O,O,O,X
X,X,X,X,X,O,X,O,T,X,X,O,X,O,X,O,X,X,X,O,X,X,X,O,X,O,X,O,X,X,X,O,X,O,X
X,O,O,O,X,O,O,O,X,O,X,O,O,O,O,O,O,O,O,O,X,O,O,O,O,O,O,O,O,O,X,O,O,O,X
X,O,X,O,X,X,X,X,X,O,X,O,X,O,X,O,X,O,X,O,X,X,X,X,X,O,X,O,X,X,X,O,X,O,X
X,O,X,O,O,O,X,O,O,O,O,O,O,O,O,O,O,O,O,O,O,O,O,O,X,O,O,O,X,O,O,O,O,O,X
X,O,X,O,X,X,X,O,X,X,X,O,X,O,X,O,X,O,X,O,X,O,X,O,X,X,X,X,X,O,X,O,X,O,X
X,O,O,O,O,O,O,O,O,O,O,O,X,O,O,O,X,O,X,O,O,O,O,O,O,O,X,O,O,O,O,O,O,O,X
X,O,X,X,X,O,X,O,X,O,X,O,X,O,X,O,X,X,X,O,X,X,X,O,X,X,X,O,X,O,X,O,X,X,X
X,O,O,O,O,O,O,O,O,O,O,O,O,O,O,O,X,O,O,O,O,O,O,O,X,O,O,O,O,O,O,O,O,O,X
X,O,X,O,X,O,X,O,X,O,X,O,X,O,X,O,X,O,X,O,X,O,X,X,X,O,X,O,X,O,X,X,X,O,X
L,O,O,O,X,O,O,O,O,O,O,O,X,O,O,O,O,O,O,O,X,O,X,O,O,O,O,O,O,O,X,O,O,O,X
X,O,X,O,X,O,X,O,X,O,X,O,X,O,X,X,X,O,X,O,X,X,X,X,X,O,X,O,X,X,X,O,X,O,X
X,O,X,O,O,O,O,O,O,O,O,O,O,O,X,O,O,O,O,O,O,O,O,O,X,O,O,O,X,O,O,O,O,O,X
X,O,X,X,X,X,X,O,X,O,X,O,X,X,X,O,X,O,X,O,X,X,X,O,X,X,X,O,X,O,X,O,X,O,X
X,O,O,O,O,O,X,O,O,O,O,O,X,O,O,O,O,O,O,O,X,O,X,O,X,O,X,O,X,O,O,O,O,O,X
X,O,X,O,X,O,X,X,X,O,X,X,X,O,X,O,X,O,X,X,X,O,X,X,X,O,X,X,X,O,X,O,X,O,X
X,O,O,O,O,O,O,O,O,O,X,O,X,O,O,O,O,O,X,O,X,O,O,O,O,O,O,O,O,O,X,O,X,O,X
X,O,X,X,X,O,X,X,X,X,X,O,X,X,X,O,X,X,X,O,X,O,X,O,X,O,X,O,X,X,X,O,X,X,X
X,O,O,O,O,O,O,O,X,O,O,O,O,O,X,O,X,O,O,O,O,O,X,O,O,O,X,O,O,O,X,O,X,O,X
X,O,X,O,X,X,X,O,X,O,X,O,X,X,X,X,X,O,X,O,X,O,X,O,X,O,X,X,X,O,X,X,X,O,X
X,O,O,O,O,O,O,O,O,O,X,O,X,O,O,O,X,O,X,O,O,O,O,O,X,O,O,O,X,O,O,O,O,O,X
X,X,X,X,X,O,X,O,X,O,X,O,X,O,X,X,X,O,X,O,X,O,X,O,X,O,X,O,X,O,X,X,X,X,X
X,O,O,O,O,O,O,O,X,O,O,O,O,O,X,O,X,O,O,O,X,O,O,O,O,O,O,O,X,O,X,O,X,O,X
X,O,X,X,X,O,X,O,X,X,X,O,X,X,X,O,X,O,X,O,X,O,X,O,X,O,X,O,X,O,X,O,X,O,X
X,O,X,O,X,O,O,O,X,O,X,O,X,O,O,O,O,O,O,O,O,O,X,O,O,O,O,O,O,O,X,O,O,O,X
X,O,X,O,X,X,X,O,X,O,X,X,X,O,X,O,X,O,X,O,X,O,X,O,X,X,X,O,X,O,X,O,X,O,X
X,O,O,O,O,O,O,O,O,O,O,O,O,O,O,O,X,O,O,O,X,O,O,O,O,O,X,O,O,O,O,O,X,O,X
X,X,X,X,X,X,X,X,X,X,X,X,X,X,X,X,X,X,X,X,X,X,X,X,X,X,X,X,X,X,X,X,X,X,X
